#domain
hospital
#levelname
ProgProj
#colors
blue: 0, A, E, K
red: 1, B, F, L
green: 2, C, G
purple: 3, D, H
orange: 4, I, J
cyan: 5, M, N
pink: 6, O
grey: 7, P
lightblue: 8, Q
brown: 9, R, T, V, X
#initial
+++++++++++++++++++++++++++++++++++++
+0 A      +     B     1 + O      6  +
+   +++   +   +++       + ++ ++++++ +
+    M    +        N    +     +     +
+ ++++++  +  ++++++     + +++ +++   +
+ C    E     F    D     +         + +
+ +++  +++++++  +++     + +++++ +++ +
+      +     +          +      +    +
+  G   +  H  +   2      + +++ +++++ +
+      +     +          +   +      ++
+ ++++++  +  ++++++     + + ++++++ ++
+3      I      J       4+        + ++
+ L        5          K + ++ +++   ++
+++++++++++++++++++++++++++++++++++++
+   +++++++     +++++++     +++     +
+   +     +     +  T  +       +     +
+7  +  P  +     +     +   +   +     +
+   +     +      V    +   +         +
+   +++++ +++++++++ +++ +++++++     +
+  8 Q    +       +   X   +         +
+ +++++++ + +++++ + +++++ +++++++   +
+ +       +     + +     +       +   +
+ + +++++++++ + +++++ + +++++ + +   +
+ +         + +       +     + +     +
+ +++++++   + +++++++ +++   +++++   +
+           +       R 9       +     +
+++++++++++++++++++++++++++++++++++++
#goal
+++++++++++++++++++++++++++++++++++++
+         +          K  +        6  +
+   +++   +   +++       + ++ ++++++ +
+ L  E    +    F        +     +   O +
+ ++++++  +  ++++++     + +++ +++   +
+      B     A          +         + +
+ +++  +++++++  +++     + +++++ +++ +
+   G  +  H  +      M   +      +    +
+      +     +   C      + +++ +++++ +
+      +     +          +   +      ++
+ ++++++  +  ++++++     + + ++++++ ++
+      D          I     +        + ++
+ J    N                + ++ +++   ++
+++++++++++++++++++++++++++++++++++++
+   +++++++     +++++++     +++     +
+   +     +     +     +       +     +
+7  +     +     +     +   +   +     +
+   +     +           +   +         +
+   +++++ +++++++++ +++ +++++++     +
+  Q      +       +       +         +
+ +++++++ + +++++ + +++++ +++++++   +
+ +       +     + +     +       +   +
+ + +++++++++ + +++++ + +++++ + +   +
+ +         + +       +     + +     +
+ +++++++   + +++++++ +++   +++++   +
+         P +       R         +     +
+++++++++++++++++++++++++++++++++++++
#end
